//MAP CONVERTED BY dmm2tgm.py THIS HEADER COMMENT PREVENTS RECONVERSION, DO NOT REMOVE
"a" = (
/mob/living/simple_animal/hostile/carp,
/turf/space,
/area/space)
"b" = (
/turf/simulated/mineral,
/area/ruin/space/unpowered)
"c" = (
/turf/simulated/floor/plating/asteroid/airless,
/area/ruin/space/unpowered)
"d" = (
/turf/simulated/mineral/random/high_chance,
/area/ruin/space/unpowered)
"e" = (
/turf/simulated/wall/mineral/titanium,
/area/ruin/space/unpowered)
"f" = (
/obj/machinery/door/airlock/titanium,
/turf/simulated/floor/plating/airless,
/area/ruin/space/unpowered)
"g" = (
/turf/simulated/floor/plating/airless,
/area/ruin/space/unpowered)
"h" = (
/turf/simulated/floor/mineral/titanium/blue/airless,
/area/ruin/space/unpowered)
"i" = (
/obj/structure/window/reinforced{
	dir = 8
	},
/obj/structure/chair/comfy/shuttle,
/turf/simulated/floor/mineral/titanium/blue/airless,
/area/ruin/space/unpowered)
"j" = (
/obj/structure/chair/comfy/shuttle,
/turf/simulated/floor/mineral/titanium/blue/airless,
/area/ruin/space/unpowered)
"k" = (
/obj/effect/spawner/lootdrop/crate_spawner,
/turf/simulated/floor/mineral/titanium/blue/airless,
/area/ruin/space/unpowered)
"l" = (
/obj/structure/shuttle/engine/propulsion{
	dir = 4
	},
/turf/simulated/floor/plating/airless,
/area/ruin/space/unpowered)
"m" = (
/obj/item/shard,
/turf/simulated/floor/plating/airless,
/area/ruin/space/unpowered)
"n" = (
/obj/structure/chair/comfy/shuttle{
	dir = 8
	},
/turf/simulated/floor/plating/airless,
/area/ruin/space/unpowered)
"o" = (
/obj/structure/grille,
/turf/simulated/floor/plating/airless,
/area/ruin/space/unpowered)
"p" = (
/obj/structure/table,
/turf/simulated/floor/mineral/titanium/blue/airless,
/area/ruin/space/unpowered)
"q" = (
/obj/item/shard,
/obj/structure/chair/comfy/shuttle{
	dir = 8
	},
/turf/simulated/floor/mineral/titanium/blue/airless,
/area/ruin/space/unpowered)
"r" = (
/obj/structure/window/reinforced{
	dir = 8
	},
/obj/structure/chair/comfy/shuttle{
	dir = 1
	},
/turf/simulated/floor/mineral/titanium/blue/airless,
/area/ruin/space/unpowered)
"s" = (
/obj/structure/chair/comfy/shuttle{
	dir = 1
	},
/turf/simulated/floor/plating/airless,
/area/ruin/space/unpowered)
"t" = (
/obj/structure/girder,
/turf/simulated/floor/plating/airless,
/area/ruin/space/unpowered)
"K" = (
/obj/structure/spawner/mining/basilisk,
/turf/simulated/floor/plating/asteroid/airless,
/area/ruin/space/unpowered)
"Z" = (
/turf/space,
/area/space)

(1,1,1) = {"
Z
Z
Z
Z
Z
Z
Z
Z
Z
Z
Z
Z
Z
Z
Z
Z
Z
Z
Z
Z
Z
Z
Z
Z
Z
Z
Z
Z
Z
Z
Z
Z
Z
Z
Z
Z
Z
Z
"}
(2,1,1) = {"
Z
Z
Z
Z
Z
Z
Z
Z
Z
Z
Z
Z
Z
Z
Z
Z
Z
Z
Z
Z
Z
Z
Z
b
Z
Z
Z
Z
Z
Z
Z
Z
Z
Z
Z
Z
Z
Z
"}
(3,1,1) = {"
Z
Z
Z
Z
Z
Z
Z
Z
Z
Z
Z
Z
Z
Z
Z
Z
Z
Z
Z
a
Z
Z
Z
Z
Z
Z
b
b
Z
Z
Z
Z
Z
Z
Z
Z
Z
Z
"}
(4,1,1) = {"
Z
Z
Z
Z
c
c
Z
Z
Z
a
Z
Z
Z
Z
Z
Z
Z
Z
Z
Z
Z
Z
Z
Z
Z
b
b
b
Z
Z
Z
Z
Z
Z
Z
Z
Z
Z
"}
(5,1,1) = {"
Z
Z
Z
b
c
c
c
Z
Z
Z
Z
Z
Z
Z
Z
Z
Z
Z
Z
Z
Z
b
Z
Z
Z
b
b
Z
Z
Z
Z
Z
Z
Z
Z
Z
Z
Z
"}
(6,1,1) = {"
Z
Z
b
b
c
c
c
Z
Z
Z
Z
Z
Z
Z
Z
Z
Z
Z
Z
Z
Z
Z
Z
Z
Z
Z
Z
Z
Z
Z
Z
Z
Z
Z
Z
Z
Z
Z
"}
(7,1,1) = {"
Z
Z
b
b
b
b
b
Z
Z
Z
Z
Z
Z
c
c
Z
Z
Z
Z
Z
Z
Z
Z
Z
Z
Z
Z
Z
Z
Z
Z
Z
Z
Z
Z
Z
Z
Z
"}
(8,1,1) = {"
Z
Z
b
b
b
b
b
Z
Z
Z
Z
Z
Z
c
c
c
c
c
c
c
Z
Z
Z
Z
Z
Z
Z
Z
Z
Z
Z
Z
Z
Z
Z
Z
Z
Z
"}
(9,1,1) = {"
Z
Z
Z
Z
b
b
Z
Z
Z
Z
Z
Z
Z
c
c
c
c
c
c
c
b
b
b
Z
Z
Z
Z
Z
Z
Z
Z
Z
Z
Z
Z
Z
Z
Z
"}
(10,1,1) = {"
Z
Z
Z
Z
b
b
Z
Z
Z
Z
Z
b
c
c
c
c
K
c
c
c
c
b
b
Z
Z
Z
Z
Z
Z
Z
Z
Z
Z
Z
Z
Z
Z
Z
"}
(11,1,1) = {"
Z
Z
Z
Z
Z
Z
Z
Z
Z
Z
Z
b
b
b
c
c
c
c
c
c
c
b
b
b
Z
Z
Z
Z
Z
a
Z
Z
Z
Z
Z
Z
Z
Z
"}
(12,1,1) = {"
Z
Z
Z
Z
Z
Z
Z
Z
Z
Z
b
b
b
b
b
b
c
c
b
b
b
b
b
b
b
Z
Z
Z
Z
Z
Z
Z
Z
Z
Z
Z
Z
Z
"}
(13,1,1) = {"
Z
Z
Z
Z
Z
Z
Z
Z
Z
Z
b
b
b
b
d
d
b
b
b
b
b
b
b
b
d
Z
Z
Z
Z
Z
Z
Z
b
b
b
Z
Z
Z
"}
(14,1,1) = {"
Z
Z
Z
Z
Z
Z
Z
Z
Z
Z
d
d
b
b
d
d
b
b
b
d
b
b
b
b
b
Z
Z
Z
Z
Z
Z
Z
Z
b
b
b
Z
Z
"}
(15,1,1) = {"
Z
Z
Z
Z
Z
Z
Z
Z
Z
Z
d
d
b
b
b
b
b
b
b
b
b
b
b
b
b
b
Z
Z
Z
Z
Z
Z
b
b
b
b
b
Z
"}
(16,1,1) = {"
Z
Z
Z
Z
Z
Z
Z
Z
Z
Z
d
d
d
b
b
b
g
g
o
b
b
c
b
b
d
d
Z
Z
Z
Z
Z
d
b
b
b
c
c
Z
"}
(17,1,1) = {"
Z
Z
Z
Z
Z
Z
Z
Z
Z
Z
d
d
b
b
c
e
g
m
p
g
e
c
b
b
d
d
Z
Z
Z
Z
d
d
b
b
d
c
c
Z
"}
(18,1,1) = {"
Z
Z
Z
Z
Z
a
Z
Z
Z
Z
d
b
b
b
c
e
g
n
q
h
e
c
b
b
d
d
Z
Z
Z
d
b
b
b
c
c
c
Z
Z
"}
(19,1,1) = {"
Z
Z
Z
Z
Z
Z
Z
Z
Z
Z
b
b
b
b
c
e
g
h
h
h
e
c
c
b
b
b
Z
Z
Z
b
b
b
b
c
K
c
Z
Z
"}
(20,1,1) = {"
Z
Z
Z
Z
Z
Z
Z
Z
Z
Z
b
b
b
c
c
e
h
h
h
h
e
c
c
c
c
b
Z
Z
d
b
b
c
c
c
c
c
Z
Z
"}
(21,1,1) = {"
Z
Z
Z
Z
Z
Z
Z
Z
Z
Z
Z
b
b
c
c
f
h
h
h
h
f
c
K
c
c
b
Z
b
b
b
b
c
c
c
Z
Z
Z
Z
"}
(22,1,1) = {"
Z
Z
Z
Z
Z
Z
Z
Z
Z
Z
Z
b
b
b
c
e
i
h
h
r
e
c
c
c
c
Z
Z
b
b
b
c
c
c
Z
Z
Z
Z
Z
"}
(23,1,1) = {"
Z
Z
Z
Z
Z
Z
Z
Z
b
Z
Z
b
b
b
c
e
j
h
h
s
t
c
c
c
c
Z
Z
b
b
c
Z
Z
Z
Z
Z
Z
Z
Z
"}
(24,1,1) = {"
Z
Z
Z
Z
Z
Z
Z
Z
Z
Z
b
b
b
d
c
e
k
h
g
g
g
c
c
Z
Z
Z
Z
Z
b
c
Z
Z
Z
Z
Z
Z
Z
Z
"}
(25,1,1) = {"
Z
Z
Z
Z
Z
b
b
Z
Z
Z
b
b
b
d
c
e
e
e
e
e
e
c
c
Z
Z
Z
Z
Z
Z
Z
Z
Z
Z
Z
Z
Z
Z
Z
"}
(26,1,1) = {"
Z
Z
Z
Z
b
b
b
Z
a
Z
b
b
b
d
c
e
l
l
l
l
e
c
c
Z
Z
Z
Z
Z
Z
Z
Z
Z
Z
Z
Z
Z
Z
Z
"}
(27,1,1) = {"
Z
Z
Z
Z
Z
b
b
Z
Z
Z
b
b
b
b
b
c
c
c
c
c
c
c
c
Z
Z
Z
Z
Z
Z
Z
Z
Z
Z
Z
Z
Z
Z
Z
"}
(28,1,1) = {"
Z
Z
Z
Z
Z
Z
Z
Z
Z
Z
Z
b
b
b
c
c
c
c
c
Z
Z
Z
Z
Z
Z
Z
a
Z
Z
Z
Z
Z
Z
Z
Z
Z
Z
Z
"}
(29,1,1) = {"
Z
Z
Z
Z
Z
Z
Z
Z
Z
Z
Z
Z
b
b
c
c
c
c
c
Z
Z
Z
Z
Z
Z
Z
Z
Z
Z
Z
Z
Z
Z
Z
Z
Z
Z
Z
"}
(30,1,1) = {"
Z
Z
Z
Z
Z
Z
Z
Z
Z
Z
Z
Z
Z
Z
Z
Z
Z
Z
Z
Z
Z
Z
Z
Z
Z
Z
Z
Z
Z
Z
Z
Z
Z
Z
Z
Z
Z
Z
"}
(31,1,1) = {"
Z
a
Z
Z
Z
Z
Z
Z
Z
Z
Z
Z
Z
Z
Z
Z
Z
Z
Z
Z
Z
Z
Z
Z
Z
Z
Z
Z
Z
Z
Z
Z
Z
Z
Z
Z
Z
Z
"}
(32,1,1) = {"
Z
Z
Z
Z
Z
Z
Z
Z
Z
Z
Z
Z
Z
Z
Z
Z
Z
Z
Z
Z
Z
Z
Z
Z
Z
Z
Z
Z
c
c
c
Z
Z
Z
Z
Z
Z
Z
"}
(33,1,1) = {"
Z
Z
Z
Z
Z
Z
Z
Z
Z
Z
Z
Z
Z
Z
Z
Z
Z
Z
Z
Z
a
Z
Z
Z
Z
Z
Z
c
c
b
b
Z
Z
Z
Z
Z
Z
Z
"}
(34,1,1) = {"
Z
Z
Z
Z
Z
Z
Z
Z
Z
Z
Z
Z
Z
Z
Z
Z
Z
Z
Z
Z
Z
Z
Z
Z
Z
Z
Z
c
c
d
b
Z
Z
Z
Z
Z
Z
Z
"}
(35,1,1) = {"
Z
Z
Z
Z
Z
Z
Z
Z
Z
Z
Z
Z
Z
Z
Z
Z
Z
Z
Z
Z
Z
Z
Z
Z
Z
b
Z
b
d
b
b
Z
Z
Z
Z
Z
Z
Z
"}
(36,1,1) = {"
Z
Z
Z
Z
Z
Z
Z
Z
Z
Z
Z
Z
Z
Z
Z
Z
Z
Z
Z
Z
Z
Z
Z
Z
Z
Z
Z
b
b
Z
Z
Z
Z
Z
Z
Z
Z
Z
"}
(37,1,1) = {"
Z
Z
Z
Z
Z
Z
Z
Z
Z
Z
Z
Z
Z
Z
Z
Z
Z
Z
Z
Z
Z
Z
Z
Z
Z
Z
Z
Z
Z
Z
Z
Z
Z
Z
Z
Z
Z
Z
"}
